Level 1
########
#..C...#
#...#..#
#L.L...#
#....###
###.LK.#
#...LL.#
#P#....#
########