Impossible Level
#####
#...#
#.###
#.#K#
#.###
#.#B#
#.#B#
#.P.#
##C##
#####