Level 5
#########
#K..#...#
#B#.#.#.#
#B#.#.#.#
#B#.#.#.#
#B#.#.#.#
#B#.#.#.#
#B#.#.#.#
#B#.#.#.#
#B#.#.#.#
#B#.#.#.#
#B#.#.#.#
#B#.#.#.#
#B#...#.#
#B#####.#
CP......#
#########