Level 4
#################
#######K#########
#.....#.....#...#
#.###.#.###.#.#.#
#.#.....#...#.#.#
###.#####.###.#.#
#...#...#.....#.#
#.###.#.#######.#
#.....#.#.......#
#########.#####.#
#.#.....#.#...#.#
#.#.###.#.###.#.#
#...#...#.....#.#
###.###.#######.#
#.#...#.......#.#
#.#.#.#####.###.#
#...#.....#.....#
########CP#######
#################
