Level 2
#####
#.C.#
#LL.#
#L..#
##..#
#K#.#
#...#
###.#
#P..#
#####