Niveau couloir avec choix
#####
#...#
#.#.#
#.#K#
#.#B#
#.#B#
#.#B#
#.P.#
##C##
#####