Level 3 : Martin
########
#.LC...#
#..L#BB#
#L.L...#
#....###
###.LK.#
#...LL.#
#.#BBBB#
#.#B...#
#..L#..#
#L.L...#
#....###
###.L..#
#...LL.#
#P#....#
########