Level 1 Helltaker
.....###.
..###.C#.
.#..B..#.
.#...B#..
#..####..
#......#.
#P.....K#
#########
